....................
....................
..G.....GGGG..G.....
..G.....GABG..G.....
..G.....GCDG..G.....
..G.....GEEG..G.....
..GGGG..GGGG..GGGG..
....................
....................
....................
....................
....................
........GGG.........
.1...............X..
########...#########
