....................
....................
....................
....................
....................
....................
....................
....................
....................
....................
....................
....................
....................
.1...............X..
########...#########
