....................
....................
..........X.........
.......######.......
..G..............G..
####..G.G.G.G....###
......DGBGAGCG......
......--------......
...--...........--..
....................
.G.G............GEG.
####............####
....................
.1..................
####################
